1111111111
1000000001
1000000001
1001001001
0001001000
0001001000
1001001001
1000000001
1000000001
1111111111