1100111100
0000100000
0000100000
1111100111
0000000000
0000000000
1111111111
0000100000
0000100000
0000100000