0001000000
0001000000
0001000000
0001001111
0000000000
0000000000
1111001000
0000001000
0000001000
0000001000