**********
*...x....*
*...x....*
*..*x.*..*
...*..*...
...*..*...
*..*..*..*
*........*
*........*
**********
