**......**
*........*
..........
...****...
xxx.......
...****...
..........
..........
*........*
**......**
