**********
*........*
*.xxx....*
*........*
*........*
*........*
*........*
*........*
*........*
**********
