0000000000
0000000000
0000000000
0000000000
0000000000
1111111111
0010001000
0010001000
0010001000
0010001000